ADJ=形容词
ADJ-COMPAR=形容词比较级形式
ADJ-GRADED=能被表示程度的副词或介词词组修饰的形容词
ADJ-SUPERL=形容词最高级形式
ADJ-UNGRADED=不能被表示程度的副词或介词词组修饰的形容词
ADV=副词
ADV-BRD-NEG=广义否定结构副词
ADV-COMPAR=副词比较级形式
ADV-GRADED=能被表示程度的副词或介词词组修饰的副词
ADV-INDEF=不定副词
ADV-INDEF-NEG=否定不定副词
ADV-NEG=否定副词
ADV-SUPERL=副词最高级形式
AUX=助动词
COLOUR=颜色词
COMB-in-ADJ=与形容词构成的词
COMB-in-ADJ-GRADED=与能被表示程度的副词或介词词组修饰的形容词构成的词
COMB-in-ADJ-and-N=与形容词，名词构成的词
COMB-in-ADJ-and-N-COUNT=与形容词，可数名词构成的词
COMB-in-COLOUR=与颜色词构成的词
COMB-in-N=与名词构成的词
COMB-in-N-COUNT=与可数名词构成的词
COMB-in-N-UNCOUNT=与不可数名词构成的词
COMB-in-QUANT=与数量词构成的词
COMB-in-VERB=与动词构成的词
CONJ-COORD=并列连词
CONJ-COORD-NEG=否定并列连词
CONJ-SUBORD=从属连词
CONVENTION=惯用语
DET=限定词
DET-NEG=否定限定词
DET-POSS=所有格限定词
EXCLAM=感叹语
FRACTION=分数词
INTERJ=表示说话时的语气或感情
MODAL=情态动词
N=名词
N-COUNT=可数名词
N-COUNT-COLL=可数集合名词
N-FAMILY=家庭成员名词
N-IN-NAMES=名称名词
N-MASS=物质名词
N-PLURAL=复数名词
N-PROPER=专有名词
N-PROPER-COLL=专有集合名词
N-PROPER-PLURAL=专有复数名词
N-SING=单数名词
N-SING-COLL=单数集合名词
N-TITLE=头衔名词
N-UNCOUNT=不可数名词
N-UNCOUNT-COLL=不可数集合名词
N-VAR=可变名词
N-VAR-COLL=可变集合名词
N-VOC=称呼名词
NEG=否定词
NUM=数词
ORD=序数词
PREDET=前置限定词
PREFIX=前缀
PREP=介词
PRON=代词
PRON-EMPH=强调代词
PRON-INDEF=不定代词
PRON-INDEF-NEG=否定不定代词
PRON-PLURAL=复数型代词
PRON-POSS=所有格代词
PRON-RECIP=相互代词
PRON-REFL=反身代词
PRON-REFL-EMPH=强调反身代词
PRON-REL=关系代词
PRON-SING=单数型代词
QUANT=数量词
QUANT-PLURAL=复数数量词
QUEST=疑问词
SOUND=声音词
SUFFIX=后缀
V=动词
V-ERG=动词（及物/不及物）
V-LINK=连系动词
V-LINK-ERG=连系动词（及物/不及物）
V-PASSIVE=被动动词
V-RECIP=相互动词
V-RECIP-ERG=相互动词（及物/不及物）
V-RECIP-PASSIVE=被动相互动词